1111111
10PCE01
1000001
1111111