1111111111111111111111111
10010000000C1111000000011
1000011111001111000C00011
10001100P0E00000000000011
1111111111111111111111111
