1111111111111111111111111111111111
1000000000000000000000000000000001
10P00000000000000000000000C0000001
1000000000000000000000000000000001
10000C0000000000000000000000000001
1000000000000000000110000000000001
1000000000000000000000000000000001
1000000000000000000000011110000001
100000000C000000000000000000000001
1000000000000000000000000000000001
1000000000011000000000000000000001
1000000000001100000000000000000001
1000000000000000000C00000000000001
1000000000000000000000000000000001
1000000000000000000000000000000001
10000000111100000000000000000C0001
1000000000000000000000000000000001
1000000C00000000000000000000000E01
1000000000000000000000000000000001
1111111111111111111111111111111111