1111111
1000001
101P101
10C0E01
1111111