1111111111111111111111111111111111111111
1000100001010C01100000000101100010000101
101C001000000000100000000000C10000100001
100000100000000000011000000000010C001001
1001000000C00000C0001000010000000000C001
110C001000C001000100010110C0000000000001
1000000000000000000000110100000100101011
100000011P0000C110CC00000100000010001001
1010000011000000000000110000000000011011
1C01010100100000001001000001000010000001
110001000000000000010C101000000000010001
1100100000000000001000000000100000001011
1010010000100011000C1000C1100100000001C1
1010000100000000CC0000000100010000000001
10000000000000001000000100000010C0101001
10000000C00010000100C0000110000000000001
1000010000000000000010100000010000000001
100C000000001000101000000000100010000001
10001000CC0C0000000000000000001010001001
100010010000000000001000C000000000000001
1000000010000000000000001000001011000101
11011100000000C00000100000000010C1000001
100100100C001100000001000000010000C00101
10000000000000C0000001000000100001000001
10101000000100000000000000100000C0000001
100000100101000000001110C000110000000001
1000000000000001100000000000100000000C01
1010E00000010000000000000100110000000101
1000100000010010100000010000000000001001
1100001000000001000010010000000C00100001
110100000000C000000000011000100000000C01
11010C00001000000000000000000C0C00000001
10010000000000C001011000000000C000000001
1000001000000000000000000000000000100001
1010010000000000000000000000000000011001
100000C000010000000C000C000000C001000001
10100010000010000C100000000C000000100001
1000000000100000000001010000000000100001
1000000100000000010000100000000001000001
1001001010011100000100101001010101000001
1111111111111111111111111111111111111111