11111111111
1P100000011
10100001001
10000100001
10010100C11
1C010001001
10100010001
10000001001
1000CE01001
11111111111